10 10
..#########
..#.#.....#
#.#.#.###.#
#.....#...#
#.#######.#
#...#.#.#.#
#.#.#.#.###
#.#...#...#
#.###.#.###
#.#.......
#########.