21 21
..###################
........#.#.#.......#
###.###.#.#.#######.#
#.#...#...#...#.#...#
#.#.#.#######.#.#.###
#.#.#...............#
#.###.#####.#.#######
#...#.....#.#.#.....#
#.#.#####.###.###.###
#.#.....#.#...#...#.#
#.#####.###.###.#.#.#
#...#...#.....#.#...#
#####.#.#.#####.###.#
#.....#.........#...#
#.#####.#.###########
#...#...#.........#.#
#.###.#.#.###.#####.#
#...#.#.#...#...#...#
###.#####.###.#.#.#.#
#.......#...#.#...#.
###################.